Country,1800,1801,1802
AGO,0,0,0
ARG,0,0,1
AUS,0,0,0
AUT,0,0,0
ESP,1,0,0